1 OO   RK
  OOOOOOO
  O
OOOOO OOO
T  O   OO      
OOOOO  O*
 O RO OOO
 O OO OOO
GO      2