OOOOOOOOOO
O  OO  RKO
O  OOoOOOO
O  o    1O
OOOOOO OOO
O T o  O*O
O OoOO  OO
O O RO OOO
OGO OO  2O
OOOOOOOOOO